10000000000000
10000000000000
11101110000010
10000001110100
10000000000000
10000000000000
10000000000000
10020220202222
10000000000000
10000000000000
10000000000000
10000000000000
10000000000000
10000000000000
