1000000000000000
1000000000000000
1010001010101011
1000000000000000
1000000000000000
1000000202000000
1000200000222200
1000000000000200
1000000000000000
1000000000000000
1000000000000000
1000000000000000
1000000000000000
1000000000000000
