10000000000000000000000000000000000
10000000000000000000000000000000000
10000000000000000000000000000000000
11101101011101110101000101001001001
10000000000000110000000000010000001
10000000000000001110010000101100010
10000000000000000000000000000000000
10000000000000000001001000000000000
10000000000000000000000010000000000
10000000000000000000000000000000000
10000000000000000000000000000000000
10000000000000000000000000000000000
10000000000000000000000000000000000
10000000000000000000000000000000000
