100000000000000000000000000000
111111111111111111111111111110
100000100000000000000000000010
100000100000000000000000000010
100000111111111111111111111010
100000100000000000000000000010
100000100000000000000000000010
100000100000000000000000000011
100000100000000000000000000011
100000100000000000000000000011
100000100000000000000000000011
100000100000000000000000000010
100000100000000000000000000010
100000100000000000000000000010
